..........
..........
..........
..........
..........
..........
..........
..........
..........
..........
..........
..........
..........
..........
..........
..........
...666...5
...2611115
55.2255555
5..6233511
